111111111
000P000C1
10000E001
111111111