111111111111111111111111111111111111
1CCCC000000000000C00000000000CCCCCC1
1CCCC000000000010C0000C000000CCCCCC1
10000000000000010CCCCCC0000000000001
1000CCCCCC0000010000000C000000000001
100000000C0001111100000C000000111111
100000000C0000010000000C000000111111
100000000C0000P1000CCCCC000000000001
10000000000000010000000000000E000001
100000000000000000000000000001110001
100000000000000CCCCC0000000001110001
100000000000000000000000000000000001
111111111111111111111111111111111111