1111111111111
10010000000C1
10000111111E1
1P001100001C1
1111111111111