11111111
1P0000C1
101111N1
100C0NE1
10C0N0N1
100C0001
11111111